Albania: North Macedonia, Montenegro, Serbia
Andorra: France, Spain
Austria: Czech Republic, Germany, Hungary, Italy, Liechtenstein, Slovakia, Slovenia, Switzerland
Belarus: Latvia, Lithuania, Poland, Russia, Ukraine
Belgium: France, Germany, Luxembourg, Netherlands
Bosnia and Herzegovina: Croatia, Montenegro, Serbia
Bulgaria: Greece, North Macedonia, Romania, Serbia, Turkey
Croatia: Bosnia and Herzegovina, Hungary, Montenegro, Serbia, Slovenia
Czech Republic: Austria, Germany, Poland, Slovakia
Denmark: Germany
Estonia: Latvia, Russia
Finland: Norway, Sweden, Russia
France: Andorra, Belgium, Germany, Italy, Luxembourg, Monaco, Spain, Switzerland
Germany: Austria, Belgium, Czech Republic, Denmark, France, Luxembourg, Netherlands, Poland, Switzerland
Greece: Albania, Bulgaria, North Macedonia, Turkey
Hungary: Austria, Croatia, Romania, Serbia, Slovakia, Slovenia, Ukraine
Italy: Austria, France, San Marino, Slovenia, Switzerland, Vatican City
Latvia: Belarus, Estonia, Lithuania, Russia
Liechtenstein: Austria, Switzerland
Lithuania: Belarus, Latvia, Poland, Russia
Luxembourg: Belgium, France, Germany
North Macedonia: Albania, Bulgaria, Greece, Serbia
Moldova: Romania, Ukraine
Monaco: France
Montenegro: Albania, Bosnia and Herzegovina, Croatia, Serbia
Netherlands: Belgium, Germany
Norway: Finland, Russia, Sweden
Poland: Belarus, Czech Republic, Germany, Lithuania, Russia, Slovakia, Ukraine
Portugal: Spain
Romania: Bulgaria, Hungary, Moldova, Serbia, Ukraine
Russia: Belarus, Estonia, Finland, Latvia, Lithuania, Norway, Ukraine
San Marino: Italy
Serbia: Albania, Bosnia and Herzegovina, Bulgaria, Croatia, Hungary, Montenegro, North Macedonia, Romania
Slovakia: Austria, Czech Republic, Hungary, Poland, Ukraine
Slovenia: Austria, Croatia, Hungary, Italy
Spain: Andorra, France, Portugal
Sweden: Finland, Norway
Switzerland: Austria, France, Germany, Italy, Liechtenstein
Turkey: Bulgaria, Greece
Ukraine: Belarus, Hungary, Moldova, Poland, Romania, Russia, Slovakia
Vatican City: Italy